. . . . . # . . . . . 
. . . . . # . . . . . 
. . . . . . . . . . . 
. . . . . # . . . . . 
. . . . . # . . . . . 
# # . # # # # # . # # 
. . . . . # . . . . . 
. . . . . # . . . . . 
. . . . . . . . . . . 
. . . . . # . . . . . 
. . . . . # . . . . . 
